NO ./textures/trial_images/lvl2/spacecraft1.xpm
SO ./textures/trial_images/lvl2/spacecraft4.xpm
WE ./textures/trial_images/lvl2/spacecraft3.xpm  
EA ./textures/trial_images/lvl2/spacecraft2.xpm

F 20,20,20
C 22,0,44

111111111111111111111111111111111111111
100000000000010000111111111111111111111
1000000000000D0000010000000111111111111
110000000000010000110000111111111111111
110000000000011111110000100000000001111
11100000W0000D0000000000D00000000000111
110000000000010000001111100000000001111
111111D10000010000001000000001111111111
1000000100000D0000001000000111111111111
100000010000010000001111111111111111111
111111111111111111111111111111111111111
