NO ./textures/trial_images/lvl1/stone.xpm
SO ./textures/trial_images/lvl1/stone_w_b.xpm
WE ./textures/trial_images/lvl1/blue2.xpm   
EA ./textures/trial_images/lvl1/stone_blue.xpm

F 20,20,20
C 22,0,44

11111111111111111111111111111
1000001000000000000000W000001
100000D0000000000000000000001
11D1111111111D111111111111111
10000000000000000000000000001
10000000000000000000000000001
111111111D1111111111111111111
11111111000000000000000010001
10000000000000000000100000001
10000000000000000000000000001
11111111111111111111111111111
