NO ./textures/trial_images/lvl3/null1.xpm
SO ./textures/trial_images/lvl3/null2.xpm
WE ./textures/trial_images/lvl3/null3.xpm  
EA ./textures/trial_images/lvl3/null4.xpm

F 20,20,20
C 22,0,44

111111111111111111111111111111111111111
100000000000000000000000000000000001001
100W00001000010010010010000010000001001
1000000011000100100100100000100000011D1
1000000010100D00100D00100000D0000000001
10000000D0010100100100D0000010000000001
100000001000110010010010000010000000001
100000001000110011110011110011110000001
111111111111111111111111111111111111111
