NO ./textures/trial_images/lvl2/spacecraft1.xpm
SO ./textures/trial_images/lvl2/spacecraft4.xpm
WE ./textures/trial_images/lvl2/spacecraft3.xpm  
EA ./textures/trial_images/lvl2/spacecraft2.xpm

F 20,20,20
C 22,0,44

111111111111111111111111111111111111111
100000000000000000001111111111111111111
100000000000000000000000000111111111111
110000000000000000000000000001111111111
110000000000000000000000000000000001111
11100000W00000000000000000000000000011
110000000000000000000000000000000001111
110000000000000000000000000001111111111
100000000000000000000000000111111111111
100000000000000000001111111111111111111
111111111111111111111111111111111111111
