C     255,255,0
NO   ./textures/trial_images/trial4.xpm
SO   ./textures/trial_images/trial3.xpm
WE   ./textures/trial_images/trial2.xpm
EA   ./textures/trial_images/trial1.xpm

F     220,255,255

        1111111111111111111111111
        10000000001100000000000W1
        1011000001110000000000001
        1001000000000000000000001
111111111111011111111111111111111
100000000011000001110111111111111
11110111111111011100000010001
11110111111111011101010010001
10000000110101011100000010001
10000000000000001100000010001    1
100000000000000000001010000001   101
100000011101000111110111100011   1
10110111 1110001 1010000000001
11111111 1111111 1111111111111