NO ./textures/trial_images/stone_blue.xpm
SO ./textures/trial_images/stone_purple.xpm
WE ./textures/trial_images/stone_white.xpm   
EA ./textures/trial_images/stone_w_b.xpm

F 20,20,20
C 22,0,44

11111111111111111111111111111
10000000000100000000000011111
10110000001100000000000001111
100d0000000000000000000W11111
11111111101111D11111100000001
10000000000000000000011111111
11110111111111011100000010001
11110111111111011101010010001
11000000110101D11100000010001
10000000000000001100000010001
10000000000000001101010010001
11000001110101011111011110001
11110011111101011101111010001
11111111111111111111111111111
