NO ./textures/trial_images/trial4.xpm
SO ./textures/trial_images/trial3.xpm
WE ./textures/trial_images/trial2.xpm   
EA ./textures/trial_images/trial1.xpm

F 20,20,20
C 22,0,44

11111111111111111111111111111
11111111111111111111111111111
1011000000000W000000000001111
11111111110000000111111111111
1111111111111D111111111111111
11111111110000000111111111111
1111111111111D111111111111111
11111111111000000011111111111
1111111111111D111111111111111
11111111110000000111111111111
11111111110000000111111111111
11111111110000000111111111111
11111111111111111111111111111