NO ./textures/trial_images/trial4.xpm
SO ./textures/trial_images/trial3.xpm
WE ./textures/trial_images/trial2.xpm
EA ./textures/trial_images/trial1.xpm
        F                             0,             192          ,120

C 225,30,1

1111111
1DDDDD1
1DDDSD1
1DDDDD1
1DDDDD1
1DDDDD1
1DDDDD1
1DDDDD1
1DDDDD1
1111111