NO ./textures/trial_images/trial4.xpm
SO ./textures/trial_images/trial3.xpm
WE ./textures/trial_images/trial2.xpm  
EA ./textures/trial_images/trial1.xpm

F 20,20,20
C 22,0,44

11111111111111111111111111111
10D00000000000000000000000001
10000000000000000000000W00001
1000000d000000000000000000001
11111111111111111111111111111
