NO ./textures/trial_images/lvl3/null1.xpm
SO ./textures/trial_images/lvl3/null2.xpm
WE ./textures/trial_images/lvl3/null3.xpm  
EA ./textures/trial_images/lvl3/null4.xpm

F 20,20,20
C 22,0,44

111111111111111111111111111111111111111
100000000000000000000000000000000000001
100001000010010010010000010000000000001
100001100010010010010000010000000000001
10E001010010010010010000010000000000001
100001001010010010010000010000000000001
100001000110010010010000010000000000001
100001000110011110011110011110000000001
111111111111111111111111111111111111111
