NO ./textures/trial_images/trial4.xpm
SO ./textures/trial_images/trial3.xpm
WE ./textures/trial_images/trial2.xpm
EA ./textures/trial_images/trial1.xpm

F 50,0,0
C 22,0,44

11111
10101
10N01
11111