NO ./textures/trial_images/trial4.xpm
SO ./textures/trial_images/trial3.xpm
WE ./textures/trial_images/trial2.xpm  
EA ./textures/trial_images/trial1.xpm

F 20,20,20
C 22,0,44

11111111111111111111111111111
10000000001100000000000011111
10110000011100000000000011111
10010000000000000000000W11111
11111111101100000111000000001
10000000001100000111011111111
11110111111111011100000010001
11110111111111011101010010001
11000000110101011100000010001
10000000000000001100000010001
10000000000000001101010010001
11000001110101011111011110001
11110011111101011101111010001
11111111111111111111111111111